丗	世
亐	于
冄	冉
冨	富
冩	寫
凴	憑
勲	勳
厠	廁
厷	肱
囙	因
夀	壽
妟	ie
寕	寧
岺	岭
嵗	歲
戯	戲
昬	昏
昷	𥁕
歯	齒
歴	歷
殻	殼
産	產
発	發
籐	藤
絶	絕
緑	綠
罙	深
蒦	獲
蔴	麻
衞	衛
説	說
遀	隋
鉄	鐵
隣	鄰
頽	頹
顔	顏
駡	罵
鳯	鳳
